# Created by Octave 6.1.0, Tue Sep 27 17:36:58 2022 GMT <unknown@patada>
# name: laberinto
# type: matrix
# rows: 20
# columns: 20
 0 0 0 0 0 0 0 0 0 0 0 0 0 0 0 0 0 0 0 0
 0 1 1 1 1 1 1 1 1 1 1 1 1 1 1 1 1 1 1 0
 0 1 0 0 0 0 0 0 0 0 0 0 0 0 0 0 0 0 1 0
 0 1 0 1 1 1 1 1 1 0 1 1 1 1 1 1 1 0 1 0
 0 1 0 1 0 0 0 0 0 0 0 0 0 0 0 0 1 0 1 0
 0 1 0 1 0 1 1 1 1 1 1 1 1 1 1 0 1 0 1 0
 0 1 0 1 0 1 0 0 0 0 0 0 0 0 1 0 1 0 1 0
 0 1 0 1 0 1 0 1 1 0 1 1 1 0 1 0 1 0 1 0
 0 1 0 1 0 1 0 1 0 0 0 0 1 0 1 0 1 0 1 0
 0 1 0 1 0 1 0 1 0 1 1 0 1 0 1 0 1 0 1 0
 0 1 0 1 0 1 0 1 0 1 1 0 1 0 1 0 1 0 1 0
 0 1 0 1 0 1 0 1 0 0 0 0 1 0 1 0 1 0 1 0
 0 1 0 1 0 1 0 1 1 1 1 1 1 0 1 0 1 0 1 0
 0 1 0 1 0 1 0 0 0 0 0 0 0 0 1 0 1 0 1 0
 0 1 0 1 0 1 1 1 1 0 1 1 1 1 1 0 1 0 1 0
 0 1 0 1 0 0 0 0 0 0 0 0 0 0 0 0 1 0 1 0
 0 1 0 1 1 1 1 1 1 1 1 1 1 1 1 1 1 0 1 0
 0 1 0 0 0 0 0 0 0 0 0 0 0 0 0 0 0 0 1 0
 0 1 1 1 1 1 1 1 1 0 1 1 1 1 1 1 1 1 1 0
 0 0 0 0 0 0 0 0 0 0 0 0 0 0 0 0 0 0 0 0


