# Created by Octave 6.1.0, Sat Nov 05 12:57:46 2022 GMT <unknown@patada>
# name: laberinto3
# type: matrix
# rows: 20
# columns: 20
 0 0 0 0 0 0 0 0 0 1 0 0 0 0 0 1 0 0 0 1
 1 1 1 1 1 1 1 1 0 1 1 1 0 1 0 1 0 1 0 1
 0 0 0 0 0 0 0 1 0 0 0 1 0 1 0 1 0 1 0 1
 0 1 0 1 1 1 1 1 1 1 0 1 0 1 0 1 0 1 0 1
 0 1 0 0 0 1 0 0 0 0 0 1 0 1 0 0 0 1 0 1
 0 1 1 1 0 1 0 1 1 1 1 1 1 1 1 1 0 1 0 1
 0 1 0 0 0 1 0 1 0 0 0 0 0 0 0 1 0 1 0 1
 0 1 0 1 0 1 0 1 1 1 0 1 0 1 0 1 0 1 0 1
 0 1 0 1 0 1 0 0 0 1 0 1 0 1 0 1 0 1 0 1
 0 1 0 1 1 1 1 1 0 1 1 1 0 1 0 1 1 1 0 1
 0 1 0 1 0 0 0 1 0 1 0 0 0 1 0 0 0 1 0 1
 1 1 0 1 0 1 0 1 0 1 0 1 1 1 1 1 0 1 0 1
 0 0 0 1 0 1 0 0 0 1 0 0 0 0 0 1 0 1 0 1
 0 1 1 1 0 1 1 1 1 1 0 1 1 1 0 1 0 1 0 1
 0 0 0 1 0 1 0 0 0 0 0 1 0 1 0 1 0 1 0 1
 0 1 0 1 0 1 1 1 1 1 0 1 0 1 0 1 0 1 0 1
 0 1 0 1 0 1 0 0 0 1 0 0 0 1 0 1 0 1 0 1
 0 1 0 1 0 1 0 1 0 1 1 1 1 1 0 1 0 1 0 1
 0 1 0 0 0 0 0 1 0 0 0 0 0 0 0 1 0 0 0 1
 1 1 1 1 1 1 1 1 1 1 1 1 1 1 1 1 1 1 1 1


